0000000000000000000000-
0000000000000000000000-
0000000000000000000000-
000111001111100000000-
0001010010000000000000-
0001010010000000000000-
0001010010000000000000-
0001010010000000000000-
0001010010000000000000-
0001010010000000000000-
0001010010000000000000-
0001010010000000000000-
0001010010000000000000-
0001010010000000000000-
0001010010000000000000-
0001010010000000000000-
0001010010000000000000-
0001010010000000000000-
1111011110000000000000-
0000000000000000000000-
0000000000000000000000-
0000000000000000000000-
0000000000000000000000-
0000000000000000000000