0000000000000000000000-
0000000000000000000000-
0000000000000000000000-
0011101110110000000000-
0010101010100000000000-
0010101010100000000000-
0010101010100000000000-
0010101010100000000000-
0010101010100000000000-
0010101010100000000000-
0010101010100000000000-
0010101010100000000000-
0010101010100000000000-
0010101010100000000000-
0010101010100000000000-
0010101010100000000000-
0010101010100000000000-
1110111011100000000000-
0000000000000000000000-
0000000000000000000000-
0000000000000000000000-
0000000000000000000000-
0000000000000000000000-
0000000000000000000000