0000000000000000000000-
0000000011111100000000-
0000000010000000000000-
0000000010000000000000-
0000000010000000000000-
0000000010000000000000-
0000000010000000000000-
0000000010000000000000-
0000000010000000000000-
0000000010000000000000-
0000000010000000000000-
0000000010000000000000-
0000000010000000000000-
0000000010000000000000-
0000000010000000000000-
0000000010000000000000-
1111111110000000000000-
0000000000000000000000-
0000000000000000000000-
0000000000000000000000-
0000000000000000000000-
0000000000000000000000-
0000000000000000000000-
0000000000000000000000